[TileSet]
res//maps//Tiles.png
[MapLevel1]
0  0  0  0  0  0  0  0  0  0  0  0  0  0  0  0  0  0  
0  0  0  0  0  0  0  0  0  0  0  0  0  0  0  0  0  0  
0  0  0  0  0  0  0  0  0  0  0  0  0  0  0  0  0  0  
0  0  0  0  0  0  38 34 34 34 34 34 34 39 0  0  0  0  
0  0  0  0  0  38 42 32 32 32 32 32 32 43 39 0  0  0  
0  0  0  0  0  36 32 32 32 32 32 32 32 32 37 0  0  0  
0  0  0  0  0  36 32 32 32 32 32 32 32 32 37 0  0  0  
0  0  0  0  0  36 32 32 32 32 32 32 32 32 37 0  0  0  
0  0  0  0  0  36 32 32 32 32 32 32 32 32 37 0  0  0  
0  0  0  0  0  36 32 32 32 32 32 32 32 32 37 0  0  0  
0  0  0  0  0  36 32 32 32 32 32 32 32 32 37 0  0  0  
0  0  0  0  0  40 44 32 32 32 32 32 32 45 41 0  0  0  
0  0  0  0  0  0  40 35 35 35 35 35 35 41 0  0  0  0  
0  0  0  0  0  0  0  0  0  0  0  0  0  0  0  0  0  0  
0  0  0  0  0  0  0  0  0  0  0  0  0  0  0  0  0  0  
0  0  0  0  0  0  0  0  0  0  0  0  0  0  0  0  0  0  
[MapLevel2]
0  0  0  0  0  0  0  0  0  0  0  0  0  0  0  0  0  0  
0  0  0  0  0  0  0  0  0  0  0  0  0  0  0  0  0  0  
0  0  0  0  0  0  0  0  0  0  0  0  0  0  0  0  0  0  
0  0  0  0  0  0  38 34 34 34 34 34 34 39 0  0  0  0  
0  0  0  0  0  38 42 32 32 32 32 32 32 43 39 0  0  0  
0  0  0  0  0  36 32 32 32 32 32 32 32 32 37 0  0  0  
0  0  0  0  0  36 32 32 32 32 32 32 32 32 37 0  0  0  
0  0  0  0  0  36 32 32 32 32 32 32 32 32 37 0  0  0  
0  0  0  0  0  36 32 32 32 32 32 32 32 32 37 0  0  0  
0  0  0  0  0  36 32 32 32 32 32 32 32 32 37 0  0  0  
0  0  0  0  0  36 32 32 32 32 32 32 32 32 37 0  0  0  
0  0  0  0  0  40 44 32 32 32 32 32 32 45 41 0  0  0  
0  0  0  0  0  0  40 35 35 35 35 35 35 41 0  0  0  0  
0  0  0  0  0  0  0  0  0  0  0  0  0  0  0  0  0  0  
0  0  0  0  0  0  0  0  0  0  0  0  0  0  0  0  0  0  
0  0  0  0  0  0  0  0  0  0  0  0  0  0  0  0  0  0  