[TileSet]
res//maps//Tiles.png
[MapLevel1]
0  0  0  0  0  0  0  0  0  0  0  0  0  0  0  0  0  0  
0  0  0  0  0  0  0  0  0  0  0  0  0  0  0  0  0  0  
0  0  0  0  0  0  0  0  0  0  0  0  0  0  0  0  0  0  
0  0  0  0  0  0  20 16 16 16 16 21 0  0  0  0  0  0  
0  0  0  0  0  20 24 15 15 15 15 25 16 21 0  0  0  0  
0  0  0  0  20 24 15 15 15 15 15 15 15 19 0  0  0  0  
0  0  0  0  18 15 15 15 15 15 15 15 15 25 21 0  0  0  
0  0  0  0  18 15 15 15 15 15 15 15 15 15 19 0  0  0  
0  0  0  0  22 26 15 15 15 15 15 15 15 15 19 0  0  0  
0  0  0  0  0  22 17 26 15 15 15 15 15 27 23 0  0  0  
0  0  0  0  0  0  0  22 26 15 15 27 17 23 0  0  0  0  
0  0  0  0  0  0  0  0  22 17 17 23 0  0  0  0  0  0  
0  0  0  0  0  0  0  0  0  0  0  0  0  0  0  0  0  0  
0  0  0  0  0  0  0  0  0  0  0  0  0  0  0  0  0  0  
0  0  0  0  0  0  0  0  0  0  0  0  0  0  0  0  0  0  
0  0  0  0  0  0  0  0  0  0  0  0  0  0  0  0  0  0  
[MapLevel2]
0  0  0  0  0  0  0  0  0  0  0  0  0  0  0  0  0  0  
0  0  0  0  0  0  0  0  0  0  0  0  0  0  0  0  0  0  
0  0  0  0  0  0  0  0  0  0  0  0  0  0  0  0  0  0  
0  0  0  0  0  0  20 16 16 16 16 21 0  0  0  0  0  0  
0  0  0  0  0  20 24 15 15 15 15 25 16 21 0  0  0  0  
0  0  0  0  20 24 15 15 15 15 15 15 15 19 0  0  0  0  
0  0  0  0  18 15 15 15 15 15 15 15 15 25 21 0  0  0  
0  0  0  0  18 15 15 15 15 15 15 15 0  15 19 0  0  0  
0  0  0  0  22 26 15 15 0  15 15 15 15 15 19 0  0  0  
0  0  0  0  0  22 17 26 15 15 15 15 0  27 23 0  0  0  
0  0  0  0  0  0  0  22 26 15 15 27 17 23 0  0  0  0  
0  0  0  0  0  0  0  0  22 17 17 23 0  0  0  0  0  0  
0  0  0  0  0  0  0  0  0  0  0  0  0  0  0  0  0  0  
0  0  0  0  0  0  0  0  0  0  0  0  0  0  0  0  0  0  
0  0  0  0  0  0  0  0  0  0  0  0  0  0  0  0  0  0  
0  0  0  0  0  0  0  0  0  0  0  0  0  0  0  0  0  0  