[TileSet]
res//tiles//tutorial_tiles.png

[Map]
0  0  0  0  0  0  0  0  0  0  0  0  0  0  0  0  0  0  0  0  0  0  0  0  0  0  0  0  0  0  0  0  0  0  0  0  0  0
0  0  9  2  2  2  6  0  0  0  0  0  0  0  0  0  0  0  0  0  0  0  0  0  0  0  0  0  0  0  0  0  0  0  0  0  0  0
0  9  13 1  1  1  10 2  2  2  2  2  2  6  0  0  9  2  2  2  6  0  0  0  9  6  0  0  0  0  0  0  0  0  0  0  0  0
0  5  1  14 1  1  1  1  1  1  1  1  16 3  0  0  5  16 1  1  10 2  2  2  13 10 2  2  2  2  6  0  0  0  0  0  0  0
0  5  1  1  1  1  1  1  1  1  1  1  1  3  0  0  5  1  1  11 4  12 11 4  4  4  4  4  12 1  10 2  6  0  0  0  0  0
0  5  1  1  1  1  1  11 4  4  4  4  4  7  0  0  5  1  1  3  0  5  3  0  0  0  0  0  5  1  1  17 3  0  0  0  0  0
0  8  12 1  1  1  1  3  0  0  0  0  0  0  0  0  5  1  1  3  0  5  3  0  9  6  0  0  5  1  11 4  7  0  0  0  0  0
0  0  5  1  1  1  1  3  0  0  0  0  0  0  0  0  8  4  4  7  0  5  10 2  13 10 2  2  13 1  3  0  0  0  0  0  0  0
0  0  8  12 1  1  1  10 2  2  2  6  0  0  0  0  0  0  0  0  0  8  4  4  4  4  4  4  4  4  7  0  0  0  0  0  0  0
0  0  0  5  1  1  1  1  1  1  1  3  0  0  0  0  0  0  0  0  0  0  0  0  0  0  0  0  0  0  0  0  0  0  0  0  0  0
0  0  0  5  1  1  1  1  1  1  1  10 6  0  0  0  0  0  0  0  0  0  0  0  0  0  0  0  0  0  0  0  0  0  0  0  0  0
0  0  0  8  12 1  1  1  1  1  1  1  10 6  0  0  0  0  0  0  0  0  0  0  0  0  0  0  0  0  0  0  0  0  0  0  0  0
0  0  0  0  8  4  4  4  4  12 1  1  1  3  0  0  0  0  0  0  0  0  0  0  0  0  0  0  0  0  0  0  0  0  0  0  0  0
0  0  0  0  0  0  0  0  0  5  1  1  1  10 2  6  0  0  0  0  0  0  0  0  0  0  0  0  0  0  0  0  0  0  0  0  0  0
0  0  0  0  0  0  0  0  0  5  1  1  1  1  1  3  0  0  0  0  0  0  0  0  0  0  0  0  0  0  0  0  0  0  0  0  0  0
0  0  0  0  0  0  0  0  0  5  1  1  1  1  1  3  0  0  0  0  0  0  0  0  0  0  0  0  0  0  0  0  0  0  0  0  0  0
0  0  0  0  0  0  0  0  0  8  12 1  1  1  11 7  0  0  0  0  0  0  0  0  0  0  0  0  0  0  0  0  0  0  0  0  0  0
0  0  0  0  0  0  0  0  0  0  8  4  4  4  7  0  0  0  0  0  0  0  0  0  0  0  0  0  0  0  0  0  0  0  0  0  0  0
0  0  0  0  0  0  0  0  0  0  0  0  0  0  0  0  0  0  0  0  0  0  0  0  0  0  0  0  0  0  0  0  0  0  0  0  0  0
0  0  0  0  0  0  0  0  0  0  0  0  0  0  0  0  0  0  0  0  0  0  0  0  0  0  0  0  0  0  0  0  0  0  0  0  0  0
0  0  0  0  0  0  0  0  0  0  0  0  0  0  0  0  0  0  0  0  0  0  0  0  0  0  0  0  0  0  0  0  0  0  0  0  0  0
0  0  0  0  0  0  0  0  0  0  0  0  0  0  0  0  0  0  0  0  0  0  0  0  0  0  0  0  0  0  0  0  0  0  0  0  0  0
0  0  0  0  0  0  0  0  0  0  0  0  0  0  0  0  0  0  0  0  0  0  0  0  0  0  0  0  0  0  0  0  0  0  0  0  0  0
0  0  0  0  0  0  0  0  0  0  0  0  0  0  0  0  0  0  0  0  0  0  0  0  0  0  0  0  0  0  0  0  0  0  0  0  0  0
0  0  0  0  0  0  0  0  0  0  0  0  0  0  0  0  0  0  0  0  0  0  0  0  0  0  0  0  0  0  0  0  0  0  0  0  0  0
0  0  0  0  0  0  0  0  0  0  0  0  0  0  0  0  0  0  0  0  0  0  0  0  0  0  0  0  0  0  0  0  0  0  0  0  0  0