[TileSet]
res//maps//Tiles.png
[MapLevel1]
0  0  0  0  0  0  0  0  0  0  0  0  0  0  0  0  0  0  0  0  
0  0  0  0  0  0  0  0  0  0  0  0  0  0  0  0  0  0  0  0  
0  0  0  0  0  0  0  0  0  0  0  0  0  0  0  0  0  0  0  0  
0  0  0  0  0  0  0  0  0  0  0  0  0  0  0  0  0  0  0  0  
0  0  0  0  0  0  0  13 1  1  1  1  1  0  0  0  0  0  0  0  
0  0  0  0  0  0  13 1  1  1  1  1  1  0  0  0  0  0  0  0  
0  0  0  0  0  0  1  1  1  1  1  1  1  0  0  0  0  0  0  0  
0  0  0  0  0  0  1  1  1  1  1  1  1  0  0  0  0  0  0  0  
0  0  0  0  0  0  1  1  1  1  1  1  1  0  0  0  0  0  0  0  
0  0  0  0  0  0  1  1  1  1  1  1  1  0  0  0  0  0  0  0  
0  0  0  0  0  0  12 1  1  1  1  1  11 0  0  0  0  0  0  0  
0  0  0  0  0  0  0  0  0  0  0  0  0  0  0  0  0  0  0  0  
0  0  0  0  0  0  0  0  0  0  0  0  0  0  0  0  0  0  0  0  
0  0  0  0  0  0  0  0  0  0  0  0  0  0  0  0  0  0  0  0  
0  0  0  0  0  0  0  0  0  0  0  0  0  0  0  0  0  0  0  0  
0  0  0  0  0  0  0  0  0  0  0  0  0  0  0  0  0  0  0  0  
0  0  0  0  0  0  0  0  0  0  0  0  0  0  0  0  0  0  0  0  
0  0  0  0  0  0  0  0  0  0  0  0  0  0  0  0  0  0  0  0  
[MapLevel2]
0  0  0  0  0  0  0  0  0  0  0  0  0  0  0  0  0  0  0  0  
0  0  0  0  0  0  0  0  0  0  0  0  0  0  0  0  0  0  0  0  
0  0  0  0  0  0  0  0  0  0  0  0  0  0  0  0  0  0  0  0  
0  0  0  0  0  0  0  0  0  0  0  0  0  0  0  0  0  0  0  0  
0  0  0  0  0  0  0  13 1  1  1  1  1  0  0  0  0  0  0  0  
0  0  0  0  0  0  13 1  1  1  1  0  1  0  0  0  0  0  0  0  
0  0  0  0  0  0  1  1  1  1  1  1  1  0  0  0  0  0  0  0  
0  0  0  0  0  0  1  1  1  0  1  1  1  0  0  0  0  0  0  0  
0  0  0  0  0  0  1  1  1  1  1  1  1  0  0  0  0  0  0  0  
0  0  0  0  0  0  0  1  1  1  1  1  1  0  0  0  0  0  0  0  
0  0  0  0  0  0  12 1  1  1  1  1  11 0  0  0  0  0  0  0  
0  0  0  0  0  0  0  0  0  0  0  0  0  0  0  0  0  0  0  0  
0  0  0  0  0  0  0  0  0  0  0  0  0  0  0  0  0  0  0  0  
0  0  0  0  0  0  0  0  0  0  0  0  0  0  0  0  0  0  0  0  
0  0  0  0  0  0  0  0  0  0  0  0  0  0  0  0  0  0  0  0  
0  0  0  0  0  0  0  0  0  0  0  0  0  0  0  0  0  0  0  0  
0  0  0  0  0  0  0  0  0  0  0  0  0  0  0  0  0  0  0  0  
0  0  0  0  0  0  0  0  0  0  0  0  0  0  0  0  0  0  0  0  